#S#################
#.....####.....####
####..#############
####.#########.####
####.#########.####
####...#######.####
######.#####...####
#####..###..#######
#.....####....#####
##.##.#############
##.##........######
##.#########.######
##....######.#...##
#####.##..##.######
#####.####...######
#####.####.########
##...............##
################.##
###..............##
###E###############